5 5 5 5 5 5 5 5 5 5 5 5 5 5 5 5 5 5 5 5 5 5 5 5 5 5 5 5 5 5 5 5 5 5 5 5 5 5 5 5 5 5 5 5 5 5 5 5 5 5 
5 5 5 5 5 5 5 5 5 5 5 5 5 5 5 5 5 5 5 5 5 5 5 5 5 5 5 5 5 5 5 5 5 5 5 5 5 5 5 5 5 5 5 5 5 5 5 5 5 5 
5 5 5 5 5 5 5 5 5 5 5 5 5 5 5 5 5 5 5 5 5 5 5 5 5 5 5 5 5 5 5 5 5 5 5 5 5 5 5 5 5 5 5 5 5 5 5 5 5 5 
5 5 5 5 5 5 5 5 5 5 5 5 5 5 5 5 4 4 4 4 4 4 4 4 4 5 5 5 5 4 4 4 4 5 5 5 5 5 5 5 5 5 5 5 5 5 5 5 5 5 
5 5 5 5 5 5 5 5 5 5 5 5 5 5 5 5 4 1 1 1 1 1 1 1 4 4 5 5 5 4 4 4 4 4 4 4 4 5 5 5 5 5 5 5 5 5 5 5 5 5 
5 5 5 5 5 5 5 5 5 5 5 5 5 5 5 4 4 1 1 1 1 1 1 1 4 4 5 5 5 4 4 4 4 4 4 4 4 5 5 5 5 5 5 5 5 5 5 5 5 5 
5 5 5 5 5 5 5 5 5 5 5 5 5 5 5 4 1 1 1 1 1 1 1 1 4 4 5 5 5 4 4 4 4 4 4 4 4 5 5 5 5 5 5 5 5 5 5 5 5 5 
5 5 5 5 5 5 5 5 5 5 5 5 5 5 4 4 1 1 1 1 1 1 1 1 4 4 5 5 4 4 4 4 4 1 1 4 4 4 5 5 5 5 5 5 5 5 5 5 5 5 
5 5 5 5 5 5 5 5 5 5 5 5 5 4 4 4 1 1 1 1 4 4 4 4 4 5 5 5 4 4 4 1 1 1 1 4 4 4 5 5 5 5 5 5 5 5 5 5 5 5 
5 5 5 5 5 5 5 5 5 5 5 5 4 4 4 4 4 1 1 1 4 5 5 5 5 5 5 4 4 4 1 1 1 1 1 1 1 4 4 5 5 5 5 5 5 5 5 5 5 5 
5 5 5 5 5 5 5 5 5 5 5 5 4 4 4 4 4 2 4 4 4 5 5 5 5 5 4 4 1 1 1 1 1 1 1 1 1 4 4 5 5 5 5 5 5 5 5 5 5 5 
5 5 5 5 5 5 5 5 5 5 5 4 4 4 4 4 4 2 4 4 4 5 5 5 5 4 4 4 1 1 1 1 1 1 1 1 1 4 4 4 5 5 5 5 5 5 5 5 5 5 
5 5 5 5 5 5 5 5 5 5 5 4 4 4 4 4 4 2 4 4 4 4 4 4 4 4 4 4 1 1 1 1 1 1 1 1 1 4 4 4 5 5 5 5 5 5 5 5 5 5 
5 5 5 5 5 5 5 5 5 5 4 4 1 1 1 4 4 2 4 4 4 4 4 4 4 4 4 4 1 1 1 1 1 1 1 1 1 4 4 4 4 5 5 5 5 5 5 5 5 5 
5 5 5 5 5 5 5 5 5 5 4 4 1 1 1 4 4 2 2 2 2 2 2 2 4 4 4 4 1 1 1 1 1 1 1 1 1 4 4 4 4 5 5 5 5 5 5 5 5 5 
5 5 5 5 5 5 5 5 5 5 4 1 1 1 1 4 4 4 4 4 4 4 4 2 4 4 4 4 4 4 4 4 2 4 4 4 4 4 4 4 4 4 5 5 5 5 5 5 5 5 
5 5 5 5 5 5 5 5 5 5 4 4 1 1 1 1 4 4 4 4 4 4 4 2 4 4 4 4 4 4 4 4 2 4 4 4 4 4 1 1 4 4 5 5 5 5 5 5 5 5 
5 5 5 5 5 5 5 5 5 5 4 4 4 1 1 1 1 1 1 1 4 1 2 2 2 4 4 4 4 4 4 4 2 2 2 4 4 4 1 1 4 4 5 5 5 5 5 5 5 5
5 5 5 5 5 5 5 5 5 5 5 5 4 4 1 1 1 5 1 1 1 1 2 2 2 4 4 4 4 4 4 4 4 4 2 1 1 1 1 1 4 4 5 5 5 5 5 5 5 5
5 5 5 5 5 5 5 5 5 5 5 5 5 4 1 1 5 5 5 1 1 2 2 2 2 2 2 2 2 2 2 2 2 2 2 4 4 4 4 4 4 4 5 5 5 5 5 5 5 5 
5 5 5 5 4 4 4 4 4 4 4 4 4 4 1 5 5 5 5 5 1 1 2 2 2 4 4 4 4 4 4 4 4 4 4 4 4 4 4 4 5 5 5 5 5 5 5 5 5 5
5 5 5 5 4 4 3 3 3 3 3 4 4 4 1 1 5 5 5 1 1 4 2 2 2 4 4 4 4 4 4 4 4 4 4 4 4 5 5 5 5 5 5 5 5 5 5 5 5 5
5 5 5 5 4 4 3 0 0 0 3 4 4 4 4 1 1 5 1 1 4 4 4 2 4 4 4 4 5 5 5 5 4 4 5 5 5 5 5 5 5 5 5 5 5 5 5 5 5 5 
5 5 5 5 4 4 3 0 0 0 3 4 4 4 4 4 1 1 1 4 4 4 4 2 4 4 4 4 5 5 5 5 5 5 5 5 5 5 5 5 5 5 5 5 5 5 5 5 5 5 
5 5 5 5 4 4 3 0 0 0 3 4 4 4 4 4 4 4 4 4 4 4 4 2 4 4 4 4 5 5 5 5 5 5 5 5 5 5 5 5 5 5 5 5 5 5 5 5 5 5 
5 5 5 5 4 4 3 3 2 3 3 4 4 4 4 4 4 4 4 4 4 4 4 2 4 4 4 4 5 5 5 5 5 5 5 5 5 5 5 5 5 5 5 5 5 5 5 5 5 5 
5 5 5 5 4 4 4 4 2 4 4 4 4 4 2 2 2 2 4 4 4 4 4 2 4 4 4 4 4 5 5 5 5 5 4 4 4 4 5 5 5 5 5 5 5 5 5 5 5 5 
5 5 5 5 4 4 4 4 2 2 2 2 2 2 2 4 4 2 2 2 2 2 2 2 4 4 4 4 4 4 4 4 4 4 4 4 4 4 5 5 5 5 5 5 5 5 5 5 5 5 
5 5 5 5 4 4 4 4 4 4 4 4 4 4 4 4 4 4 4 4 4 4 4 2 4 4 4 4 4 4 4 4 4 1 1 1 1 4 4 5 5 5 5 5 5 5 5 5 5 5 
5 5 5 5 5 5 5 5 5 5 5 5 5 5 5 5 5 4 4 4 4 4 4 2 4 4 4 4 4 1 1 1 1 1 1 1 1 4 4 5 5 5 5 5 5 5 5 5 5 5 
5 5 5 5 5 5 5 5 5 5 5 5 5 5 5 4 4 4 4 4 4 4 4 2 2 2 4 4 1 1 1 1 1 1 1 1 1 4 4 4 5 5 5 5 5 5 5 5 5 5 
5 5 5 5 5 5 5 5 5 5 5 5 4 4 4 4 4 4 4 4 4 4 4 4 4 2 4 4 1 1 1 1 1 1 1 1 1 1 4 4 5 5 5 5 5 5 5 5 5 5 
5 5 5 5 5 5 5 5 5 5 4 4 4 4 4 1 1 1 4 4 4 4 4 4 4 2 4 4 1 1 1 1 1 1 1 1 1 1 4 4 4 5 5 5 5 5 5 5 5 5 
5 5 5 5 5 5 5 5 5 4 4 4 1 1 1 1 1 1 4 2 2 2 4 4 4 2 4 4 4 4 1 1 1 1 1 1 1 4 4 4 4 5 5 5 5 5 5 5 5 5 
5 5 5 5 5 5 5 5 5 4 4 1 1 1 1 1 1 1 4 2 4 2 4 4 4 2 4 4 4 4 4 4 4 4 2 4 4 4 4 4 4 5 5 5 5 5 5 5 5 5 
5 5 5 5 5 5 5 5 5 4 4 1 1 1 1 1 1 2 2 2 4 2 2 2 2 2 2 2 2 2 2 2 2 2 2 4 4 4 4 4 5 5 5 5 5 5 5 5 5 5 
5 5 5 5 5 5 5 5 5 5 4 1 1 1 1 1 1 1 4 4 4 4 4 4 4 2 4 4 4 4 4 4 4 4 4 4 4 4 5 5 5 5 5 5 5 5 5 5 5 5 
5 5 5 5 5 5 5 5 5 5 4 4 1 1 1 1 1 1 4 4 4 4 4 4 4 2 4 4 4 4 4 4 4 4 4 4 4 5 5 5 5 5 5 5 5 5 5 5 5 5 
5 5 5 5 5 5 5 5 5 5 5 4 4 1 1 1 1 4 4 4 4 4 4 4 4 2 1 1 4 4 4 4 4 4 5 5 5 5 5 5 5 5 5 5 5 5 5 5 5 5 
5 5 5 5 5 5 5 5 5 5 5 5 4 4 4 4 4 4 4 4 4 4 1 1 1 1 1 1 1 4 4 4 4 5 5 5 5 5 5 5 5 5 5 5 5 5 5 5 5 5 
5 5 5 5 5 5 5 5 5 5 5 5 5 5 5 5 5 5 4 4 1 1 1 1 1 1 1 1 1 1 1 4 4 5 5 5 5 5 5 5 5 5 5 5 5 5 5 5 5 5 
5 5 5 5 5 5 5 5 5 5 5 5 5 5 5 5 5 5 4 4 1 1 1 1 1 1 1 1 1 1 1 4 4 5 5 5 5 5 5 5 5 5 5 5 5 5 5 5 5 5 
5 5 5 5 5 5 5 5 5 5 5 5 5 5 5 5 5 5 4 4 1 1 1 1 1 1 1 1 1 1 1 4 5 5 5 5 5 5 5 5 5 5 5 5 5 5 5 5 5 5 
5 5 5 5 5 5 5 5 5 5 5 5 5 5 5 5 5 5 4 4 1 1 1 1 1 1 1 1 1 1 1 4 5 5 5 5 5 5 5 5 5 5 5 5 5 5 5 5 5 5 
5 5 5 5 5 5 5 5 5 5 5 5 5 5 5 5 5 5 5 4 4 1 1 1 1 1 1 1 1 1 4 4 5 5 5 5 5 5 5 5 5 5 5 5 5 5 5 5 5 5 
5 5 5 5 5 5 5 5 5 5 5 5 5 5 5 5 5 5 5 5 4 4 4 1 1 1 1 1 1 4 4 5 5 5 5 5 5 5 5 5 5 5 5 5 5 5 5 5 5 5 
5 5 5 5 5 5 5 5 5 5 5 5 5 5 5 5 5 5 5 5 5 5 4 4 4 4 4 4 4 4 5 5 5 5 5 5 5 5 5 5 5 5 5 5 5 5 5 5 5 5 
5 5 5 5 5 5 5 5 5 5 5 5 5 5 5 5 5 5 5 5 5 5 5 5 5 5 5 5 5 5 5 5 5 5 5 5 5 5 5 5 5 5 5 5 5 5 5 5 5 5 
5 5 5 5 5 5 5 5 5 5 5 5 5 5 5 5 5 5 5 5 5 5 5 5 5 5 5 5 5 5 5 5 5 5 5 5 5 5 5 5 5 5 5 5 5 5 5 5 5 5 
5 5 5 5 5 5 5 5 5 5 5 5 5 5 5 5 5 5 5 5 5 5 5 5 5 5 5 5 5 5 5 5 5 5 5 5 5 5 5 5 5 5 5 5 5 5 5 5 5 5 
